NO img/grey_stone.xpm
SO img/purple_stone.xpm
WE img/red_brick.xpm
EA img/wood.xpm

C 200,200,200
F 20,20,21

11111
10001
10S01
10001
10001
10001
11001
10001
10001
10001
10001
10001
100111
110111
111111
111111

111111111111111
1sksksksksksk1
1sösösölslös1
1111111111111