NO img/grey_stone.xpm
SO img/purple_stone.xpm
WE img/red_brick.xpm
EA img/wood.xpm

F  220,100,0
C 225,30,0


11111111111111111111
11111     N     1111
11111           1111
11111111111111111111