NO img/grey_stone.xpm
SO img/purple_stone.xpm
WE img/red_brick.xpm
EA img/wood.xpm

C 200,200,200
F 23,24,22

11111
10001
10S01
10001
10001
10001
11001sldddddd
10001
10001
10001sllllllllldjv 
10001
10001
11111

slsklskd