NO      img/grey_stone.xpm
SO img/purple_stone.xpm
WE img/red_brick.xpm
EA img/wood.xpm

C  135,206,235
F 0,100,0


 111111
11111 1
   1N0       111
111011
1111
1


